Name, Visits, PageViews, Uniques/Visitors, New Visits, Returning Visits
Legacy TKI, 18916, 82819, 10024, 5943, 12973
Ako Panuku, 1027, 4593, 473, 239, 788
Arts Online, 6027, 37198, 3395, 2294, 3733
Asia Knowledge, 899, 3808, 498, 356, 543
Assessment Online, 11389, 55974, 5879, 3396, 7993
Digital technology Guidelines, 821, 4184, 409, 224, 597
e-asTTle, 7679, 14642, 3672, 2264, 5415
Education for Enterprise, 916, 4516, 459, 227, 689
Education for Sustainability, 1022, 4790, 661, 477, 545
Educational Leaders, 21097, 43437, 8490, 5531, 15566
e-Learning as Inquiry, 86, 338, 25, 13, 73
English Online, 15079, 103930, 6796, 3736, 11343
EOTC/LEOTC, 1421, 5064, 872, 613, 808
ESOL Online, 3945, 19194, 1986, 1227, 2718
He Kohinga Rauemi a Ipu Rangi (MLC), 413, 1505, 183, 128, 285
Hoatu Homai, 532, 1104, 303, 184, 348
Home-School Partnerships, 644, 2108, 364, 253, 391
ICT Helpdesk, 453, 1292, 305, 214, 239
Key Competencies, 2810, 11762, 1468, 873, 1937
Ki te Aut큰roa (Instep), 1106, 2635, 953, 901, 205
Language immersion Opportunities, 71, 218, 48, 27, 44
LEAP, 1681, 4500, 1269, 1126, 555
Learning Languages Guides, 485, 2303, 334, 262, 223
Learning languages with ICTs, 162, 433, 89, 55, 107
Literacy Online, 5000, 19390, 2124, 1023, 3977
Ma te Pouaka (M훮ori Teachers Notes), 403, 2939, 244, 174, 229
NZ Curriculum, 30470, 128790, 16743, 10545, 19925
Professional Learning, 426, 1477, 238, 136, 290
Promoting Healthy Lifestyles, 1013, 2968, 711, 540, 473
P큰taiao, 749, 2891, 351, 252, 497
RTLB, 891, 3069, 378, 229, 662
Senior Secondary Guidelines, 2188, 12625, 1168, 655, 1533
Software for Learning, 1704, 6147, 825, 553, 1151
Sounds and Words, 1104, 6080, 566, 331, 773
SSOL, 5570, 20321, 3307, 2279, 3291
Success for Boys, 356, 1274, 231, 168, 188
Taihape Area School, 156, 371, 104, 80, 76
Te Reo M훮ori, 4633, 13496, 2737, 1969, 2664
Te tere Auraki, 747, 2579, 380, 230, 517


I took 776 seconds.
